11111111
1P0C00E1
10000001
1C001C01
10000001
11111111
