111111
1P0001
111101
111001
1E1111
111111
