1111111111111111
1P00000000000C11
1011110111011011
1000000100000011
1110111110111011
1C00000000000E11
1111111111111111
