1111111
1P000E1
1010101
1C00001
100C001
1111111

