1111111111
1P00001001
1000111001
1C00000001
1111011101
1C00000C01
1011111101
1000000001
1000000E11
1111111111